+-+-+-+-+-+-+-+-+-+-+
| | | |   | |     | |
+ + + +-+ + +-+ +-+ +
|       | |   |     |
+-+-+-+ + + +-+-+ +-+
|   | |   |   |   | |
+-+ + + +-+ +-+-+ + +
|       | |     |   |
+ + +-+ + + +-+-+ +-+
| | |   | |     |   |
+-+-+-+ + + +-+-+ +-+
|   | |       |     |
+-+ + +-+ +-+-+ + +-+
| | | | |   | | |   |
+ + + + + +-+ +-+ +-+
|     |   | |   |   |
+-+-+ + +-+ + +-+ +-+
|     |   | |       |
+ + + + +-+ + +-+-+-+
| | | | |         | |
+-+-+ + +-+ + +-+-+ +
|           |       |
+ + +-+-+ + + +-+-+ +
| | |   | | |   | | |
+ +-+-+ +-+-+ +-+ +-+
| | | |   |     |   |
+-+ + + +-+ +-+-+ +-+
|           |   |   |
+-+-+-+ +-+ +-+ + + +
| |   | |         | |
+ +-+ +-+ +-+ + + +-+
|           | | | | |
+-+ + +-+ + + + + + +
|   | | | | | | |   |
+-+-+-+ +-+ + + + + +
|   |   | | | | | | |
+-+ + + + + +-+-+-+ +
|     |         |   |
+-+-+ +-+ + +-+-+-+-+
|     |   |         |
+-+-+-+-+-+-+-+-+-+-+