+-+-+-+-+-+-+-+-+-+-+-+-+-+-+-+-+-+-+-+-+-+-+-+-+-+-+-+-+-+-+-+-+-+-+-+-+-+-+-+-+-+-+-+-+-+-+-+-+-+-+
| | | |   |       |   | |               |   |   | |   |   |   |   |   | |   |       | |   |   |     |
+ + + + +-+-+-+-+ +-+ + + +-+-+-+-+-+-+ +-+ + + + + + + +-+ +-+-+ + +-+ +-+ + +-+ + + + +-+ +-+-+ +-+
| |     |     |     | | | | |   |       |     |     | |         | | | |       | | | | |   | |     | |
+ +-+-+ + +-+-+-+-+ + + +-+ + +-+-+ +-+ +-+ +-+ + +-+-+ +-+ +-+-+ + + +-+-+-+ + +-+-+ + +-+ + +-+-+ +
| | |     |                   |     |     |   | | |   |   |           |   |                   | | | |
+ + +-+-+ +-+ + + +-+ + +-+-+ +-+-+-+-+ +-+ +-+ +-+-+ + +-+-+-+-+-+-+-+ + +-+ +-+ +-+-+ +-+ + + + + +
|   | |     | | |   | | | |   |   | | |   | | |     |         |   |   | |       |   |     | | |   | |
+ +-+ +-+ +-+-+-+ +-+ +-+ +-+ +-+ + + + + + + +-+-+-+ +-+-+-+-+ +-+ +-+-+ +-+-+-+-+ +-+ + +-+-+ +-+ +
|   |         |   |   |       |   |   | |         | |         | | |   |         | |   | |           |
+ +-+-+ +-+ +-+-+ +-+-+ + + +-+-+ + +-+-+-+-+ +-+-+ + +-+-+-+-+ + + +-+ + +-+ +-+ +-+-+ + +-+ + +-+ +
|   |     | | | | | | | | | |       | | | | | | | |   |     | |         |   |         | |   | | |   |
+ +-+-+-+-+ + + +-+ + +-+ + +-+-+ + + + + + + + + +-+ + +-+-+ + +-+ +-+ + +-+ +-+ +-+-+ +-+-+-+-+ +-+
|   |   | |     | |   | | |       |           | | |       |       |   | |   |   |     |     |       |
+ +-+-+ + +-+ +-+ +-+ + +-+ + + +-+-+ + +-+-+ + + +-+ +-+-+ + +-+-+-+-+ +-+ +-+-+-+-+-+-+ +-+-+-+ + +
|         |   |     | |   | | | |     |   |   |     | | |   |   | |   | | | |         |         | | |
+ +-+-+ + +-+ +-+ +-+ +-+ +-+-+-+-+-+ + + + +-+ + +-+ + + +-+-+-+ +-+ +-+ +-+-+ +-+ +-+-+ +-+-+-+-+-+
|   |   | |     | |         |   |     | | |   | |               | |               |     |           |
+-+-+-+ +-+-+ +-+ +-+ + +-+ +-+ +-+-+ + +-+ + + +-+-+-+ +-+ +-+ + + +-+ + + +-+-+ +-+-+-+-+ + +-+-+ +
|         | | |     | | |     |     | | | | |   |   |     | |         | | | | | | |       | |     | |
+-+ +-+-+ + + +-+ +-+-+-+-+ + +-+-+ +-+-+ +-+ + + + +-+ +-+ +-+ +-+ + +-+ + + + + + +-+ + +-+-+-+-+ +
| | |             | | | |   |           |     |   |   | | |   |   | | | | |   | | |   | |         | |
+ +-+-+-+ + + + + + + + +-+-+-+-+-+ +-+ +-+-+ +-+ + +-+ + +-+-+ +-+-+ + + +-+-+ +-+ +-+-+-+ +-+-+-+ +
|   |     | | | |               | | |           | | |     | | |   | |   |               | |       | |
+ +-+ + + +-+-+ +-+ + + + +-+ +-+ +-+-+ +-+ + + +-+-+-+-+ + + +-+-+ +-+-+ +-+ + +-+-+-+ + +-+ +-+ + +
| | | | | |     |   | | |   |           |   | |     |   |     |         |   | |       |   |     | | |
+ + + + +-+ + + +-+ +-+ + +-+ + + +-+-+-+-+ +-+-+-+ + +-+ + +-+-+ +-+-+ + +-+-+-+-+-+-+ +-+-+ +-+-+-+
|     | |   | |   | | | | |   | |   |   |       | |     | |           | |   |   | |   |     |       |
+ +-+ +-+-+-+ + +-+-+ + +-+-+ + + +-+-+ +-+ +-+-+ + +-+ +-+ + +-+ + +-+-+ +-+ +-+ +-+ +-+ + +-+-+ +-+
| | | | | |   |   |   | | | | | |   |     | |     |   |   | | | | | |           |     | | | | |   | |
+-+ + + + +-+ +-+-+-+ +-+ + + +-+ +-+-+-+ + + +-+ + + +-+-+-+ + +-+-+ +-+ +-+ +-+ +-+ + +-+-+ +-+-+ +
|   | |         |       |     |   | | |       |   | |   |   | |   |     | |       |         | |   | |
+-+ +-+-+ + +-+-+-+ + +-+-+ +-+-+-+ + +-+ + + +-+-+-+-+-+ +-+-+ +-+-+-+-+-+ + +-+-+ +-+-+ + + +-+ + +
|         |   |     |         |           | |   |         |     |       |   | | | | | | | | |       |
+-+ + +-+-+ +-+-+-+-+ +-+ + +-+ + + + + +-+-+ +-+ + + + + + +-+-+-+ +-+ +-+-+ + + +-+ + +-+-+ +-+-+ +
|   | |     |   |     |   |   | | | | | |         | | | |       |     | | |                   | |   |
+-+ +-+-+-+-+ +-+-+-+ +-+-+-+-+-+ +-+-+ +-+-+ + + + +-+ + + +-+ + +-+-+-+ +-+-+-+ +-+-+ +-+-+-+ +-+ +
|   |           | | |   | |   |   |     | |   | | |   | | | |       | | | |           |   |     |   |
+-+ +-+-+ +-+-+ + + + +-+ + +-+-+ +-+-+-+ +-+ +-+-+-+-+ + +-+-+-+-+-+ + + +-+-+ +-+ +-+ +-+ +-+ +-+ +
|   |     |   |       |   |       |                 |   |     | | | |         |   |   | | |   | | | |
+-+ +-+ + + + + +-+ + +-+ +-+ +-+ +-+ +-+ + +-+ +-+-+-+ + +-+-+ + + + +-+-+-+-+-+ +-+ + + + +-+-+ + +
| | |   | | |   |   | |         |   | |   | |       |   |         |   | |       | |   |       | |   |
+ +-+-+-+-+-+ +-+ +-+-+-+-+ + +-+ +-+-+-+ +-+ + +-+ + +-+ +-+-+ + + +-+ + +-+-+-+-+-+-+-+ +-+ + + + +
|     | | |   |     | | |   |   | |         | |   | |   | | | | |       |   |           |   |   | | |
+ +-+ + + +-+ +-+ + + + + + + + +-+-+-+ + +-+ + + +-+-+-+-+ + +-+ + +-+ + +-+ +-+-+-+ +-+ +-+ + +-+ +
| | | |         | |   |   | | | |       |   | | |               | |   |       |     |   | |   | | | |
+-+ + +-+-+ +-+-+ +-+-+ +-+ + +-+-+-+-+-+ + + +-+ +-+ + + +-+-+-+ + +-+ +-+-+ + +-+-+-+ +-+ + +-+ + +
|       |     | | |   | |   | |     | |   | | |   |   | |       | |   |   |           | | | |   |   |
+-+ +-+ + +-+-+ + + +-+ +-+-+ + +-+ + + + +-+ +-+ +-+-+ +-+ + + +-+ +-+-+ +-+-+-+ +-+ +-+ + +-+ + + +
| |   |     |         | |     | | |     |   | |       |   | | | |     | |       | |       | |   | | |
+ + +-+ + +-+ + + + + +-+ + + +-+ + +-+ + +-+-+ +-+ + + +-+ +-+ +-+ +-+ +-+ +-+ +-+-+ +-+ +-+-+-+ +-+
|   |   | |   | | | | |   | |   |   | | |   | | |   | | |   |     |       |   | | | |   | | |   | | |
+ +-+-+ + +-+-+ + +-+ +-+ + +-+-+-+ + + +-+-+ +-+-+ +-+-+-+ +-+ +-+ + +-+ +-+-+ + + +-+-+-+ +-+ + + +
| |     |   |   | | |   | |   |     |   |             | |     |   | |   |     |             |       |
+ +-+-+-+ +-+-+ + + +-+-+-+ +-+-+-+ +-+ +-+-+-+ + + +-+ +-+ +-+ + + + +-+ + +-+ +-+ + +-+-+-+-+ +-+ +
| |         |   |   |       |       |       |   | |       |   | | | |   | |   | |   |   |   | | |   |
+-+-+-+ +-+ +-+ + +-+-+ +-+ + + +-+-+-+ + +-+-+ + +-+ + + +-+-+-+ +-+-+-+-+ + + +-+ + +-+-+ + +-+ + +
|       |   |   | | |   |   | | |       | |     | |   | |   |   |     | |   | | | | | |   |     | | |
+ + + +-+ +-+-+-+-+ + + +-+ +-+-+-+ +-+ +-+-+-+ +-+-+-+ +-+-+ +-+ + +-+ +-+ +-+ + +-+ +-+ + + + + + +
| | |   | | | |   | | | |     | |   | | |       | | | |         | |   |   | |       |       | | | | |
+ +-+ + +-+ + + +-+ +-+ +-+-+-+ +-+-+ +-+-+ +-+ + + + + +-+ +-+-+-+-+ + + +-+ + +-+-+ +-+ +-+-+-+ +-+
| |   |   |               | |   |   |       |       |   |   |   |   |   | | | |   |   |     |       |
+-+-+-+-+-+-+-+ +-+-+-+ +-+ + +-+ +-+ +-+-+-+-+ + +-+ +-+-+ + +-+ +-+-+ +-+ +-+-+ + + + + + +-+-+-+ +
|     |   |   | |   |   |             |         |   |   | |         | | |       | | | | | |       | |
+-+-+ +-+ +-+ +-+-+ + +-+ + + + +-+-+ +-+ +-+-+ +-+-+-+ + + + +-+ +-+ +-+-+ +-+-+-+ + +-+ +-+-+ + + +
|   |                 |   | | |     | |   |           | |   |   |           | | | | | | | |   | | | |
+-+ + +-+ + + + + + + +-+ + +-+-+ +-+-+ +-+ +-+-+ +-+-+-+-+-+ +-+ + + +-+ +-+ + + +-+-+ +-+ +-+ +-+ +
| | | | | | | | | | |   | | |       |   |       |           | |   | |   |               |   | | |   |
+ + +-+ +-+ + + +-+-+ + +-+-+ +-+ +-+-+-+-+ +-+ + +-+ + +-+-+ +-+ + + + +-+-+ + +-+ +-+ +-+ + +-+-+ +
|           | | |     |     | | | |           | |   | |   |     | | | |   | | | | | |             | |
+ + + + +-+ +-+ +-+-+ +-+-+-+ + + +-+ +-+-+ +-+ + +-+-+-+ +-+ + + + +-+-+-+ + +-+ +-+-+ +-+ + + + + +
| | | | |   | | |         | | |     |   |   |   |       |   | | | | |     |   |   | |     | | | | | |
+ + + +-+ +-+ +-+-+ + + +-+ + +-+-+-+-+-+ + +-+-+-+ +-+-+-+-+ +-+-+ +-+ +-+-+ + +-+ +-+ +-+-+-+ +-+-+
| | | |         |   | |     | |       |   |     |         | |   | | |       |       |       |       |
+ +-+-+-+ + +-+-+-+ +-+ + + +-+ +-+-+ +-+-+ +-+-+-+ + + +-+ +-+-+ +-+ +-+-+-+ +-+-+-+-+ +-+ +-+ + + +
| | |     |     |   |   | | | | | |             |   | |   | |       | |     |   |     |   | | | | | |
+ + +-+ +-+ +-+-+ +-+ +-+ +-+ +-+ + + +-+ + + +-+-+-+ +-+-+ + +-+ +-+ +-+ +-+ +-+ +-+-+ +-+-+ +-+-+ +
|   |     |   | |   |   |   |   |   |   | | | | |             | | |   | |   |         |     | |   | |
+ +-+-+ +-+ + + + +-+ + + +-+-+ +-+ +-+-+ + +-+ +-+-+ + +-+ +-+ +-+-+ + + +-+ +-+ +-+-+-+-+-+ + +-+-+
| |       | | |     | | | |           |   | | |       |   |     |           | | |     |             |
+ + +-+ +-+-+ +-+-+-+ +-+ +-+ + +-+ +-+-+ +-+ + +-+ + +-+-+ +-+-+ +-+ + +-+ +-+ + +-+-+ +-+-+-+ + + +
| | |     |     | |     | |   | |   |         |   | |     |         | | |   | |             |   | | |
+-+-+ +-+-+ +-+-+ +-+ +-+ +-+-+-+-+-+-+ + + + + +-+-+ +-+-+ + +-+-+ + +-+-+-+ +-+-+ +-+ + +-+-+-+-+ +
|       |   | | |     |       |         | | | | |         | |     | |         | |     | |     |   | |
+ + + +-+-+ + + + + +-+-+ +-+-+-+-+ + + +-+ + + +-+ +-+ + +-+-+ +-+-+-+-+ +-+-+ + +-+-+-+ +-+ + +-+-+
| | | |       |   |   |         |   | |   | | | |   | | |   | |         | | |       | |     |       |
+ +-+ +-+ + +-+ +-+-+-+ + + + +-+ + + + + + +-+ + + + +-+ +-+ + +-+-+ +-+ + +-+-+ +-+ +-+-+-+ +-+-+-+
| |     | |   |   |     | | | |   | | | | | |   | | |   |   |     | |   |   |   |         | |   |   |
+ +-+-+ + + +-+ +-+ + + +-+ + +-+ + +-+ +-+-+-+ +-+-+ +-+-+ + + +-+ +-+ + +-+-+ + +-+-+ + + +-+-+ +-+
|   |   | | |     | | | |   | |   | |     |               | | |       | | |     | |     | |   |     |
+-+ +-+-+-+-+-+ + +-+-+ + +-+ + +-+ +-+ +-+ +-+ + + +-+ +-+ +-+ + + +-+-+-+-+ +-+-+-+-+ + + +-+ +-+-+
|       |       |     | | | | | | | | |   | |   | | | | |   | | | | | | | | |         | |           |
+-+ +-+-+ + +-+ +-+ +-+-+-+ +-+ + +-+ + + +-+-+-+ + + +-+-+ + +-+-+ + + + + + +-+-+-+ + + + + + +-+ +
|   |     | |   |   |           | |     | | |     |       |   | |                   | | | | | | |   |
+ + +-+-+-+ + +-+-+-+-+ +-+ + + + +-+ +-+ + + +-+ + + + +-+ +-+ +-+ +-+-+-+ + + + + +-+ +-+-+-+ +-+ +
| | | |     | | |         | | | |       | |     | | | | |       |       |   | | | | | | | |       | |
+-+-+ +-+-+-+-+ + + + + +-+ +-+ + + +-+-+ + +-+-+-+ +-+-+-+ +-+ +-+ + + +-+-+-+ + + + +-+ +-+-+ +-+-+
| |   | |         | | | |   |   | |     | |     |       |     | |   | |     | | | |   |     |       |
+ +-+ + +-+-+ +-+-+ + + +-+ +-+-+-+ +-+-+ + +-+-+ +-+-+-+ + +-+-+-+ +-+-+ + + +-+-+ + + +-+-+-+ +-+-+
|       | | | |     | | |     |         | | |       | |   |   |       |   |   |   | | |   | |       |
+-+-+ +-+ + +-+-+ + +-+ +-+ +-+-+-+ + + +-+-+ + +-+-+ +-+-+ +-+-+ + +-+-+ + + + +-+-+-+ +-+ +-+ +-+-+
| |   |   | |     | |     | |       | |   |   |   |           | | |     | | |   | |     | |   |     |
+ +-+ + + + +-+-+ +-+ + +-+ +-+-+ + + +-+ +-+-+ +-+ + +-+-+ + + +-+ +-+-+ + + +-+ +-+-+ + +-+ + +-+-+
|   |   | | | | | |   |   | |     | |   |     | |   |   |   |     |   |   | | | | |     |     |   | |
+-+ + + +-+ + + +-+-+-+ +-+ +-+-+-+ +-+-+-+-+-+ + +-+-+ +-+-+ + +-+ + + +-+ + + + +-+-+ + +-+ + +-+ +
| |   |                   | |             | |   | |     |     | |   | |   | |       |     | | | | | |
+ + +-+ +-+ +-+-+ +-+-+ + +-+ +-+ + +-+ + + +-+ + + +-+ +-+-+ + +-+ +-+-+-+ + +-+-+ +-+ + + +-+-+ + +
|     | |     | |   |   | |     | |   | | | | | | | |   |     | | |   | |   | |   |     |   |     | |
+ + +-+ +-+ +-+ + +-+-+-+-+-+ +-+-+-+ +-+ + + +-+-+ +-+ +-+-+ +-+ +-+ + +-+-+ + +-+-+ + +-+-+ + +-+ +
| | |   | | |         |       |       | | |     |   | | |         |     |           | |       |     |
+ +-+ +-+ +-+-+-+ +-+-+-+ +-+-+ + +-+ + +-+ + + +-+ + + +-+ +-+-+ +-+ +-+ +-+ +-+-+-+-+-+-+ + + +-+ +
| |     |           | |   |     | |       | | | | |   |   |   |   |     | |               | | | |   |
+ +-+ +-+ + +-+-+ + + +-+-+ +-+ +-+ + +-+ + +-+ + + + +-+ +-+-+ +-+-+ + +-+-+ +-+ +-+ +-+-+ +-+-+ + +
|   | |   | |     |   | | | | | |   | |       | |   |   |   | | | |   | | |   |     |     |     | | |
+-+ +-+ +-+-+-+ +-+ +-+ + + + + +-+-+ +-+-+ +-+ +-+-+ +-+ +-+ +-+ + + + + + +-+-+ + +-+-+-+ + +-+ +-+
| | | | |       |     |     |   |   | | |     | |   | | |         | | |   | |     | | |   | |   | | |
+ +-+ +-+-+-+ + +-+ +-+ +-+ +-+ +-+ +-+ + + +-+-+ +-+-+ +-+-+ +-+-+ + +-+-+-+ +-+-+ + + +-+-+-+-+-+ +
|     |   |   | |   |   |     | |         |               |   |     |       | |             |   | | |
+-+-+ + +-+-+-+-+ + +-+-+-+ +-+ + + +-+ +-+ + + + +-+-+ +-+-+ +-+ +-+ +-+ + +-+ + +-+ + +-+ +-+ + + +
| |               |     |   |   | | | |   | | | |     |     | |   | | |   | |   |   | |   |         |
+ + + +-+-+ +-+-+ + +-+-+ + +-+ +-+ + + + + + +-+ + + +-+ +-+-+-+-+ + +-+ + +-+ +-+-+ + +-+-+-+ +-+ +
|   | |       |   |   |   | |     | |   | | | |   | | | |       |     | | | |   |   | | | |       | |
+ +-+ +-+ +-+-+ + +-+ +-+ + +-+ +-+ +-+-+-+ +-+-+ + + + + +-+ + +-+-+ + +-+ + +-+-+ + +-+ +-+-+-+-+-+
| |     | |     |   | |   | |   | |   |     |   | | | |     | | |       |   | |                   | |
+-+-+ + +-+-+ + +-+-+ +-+ + + + + + +-+ +-+ + +-+ +-+ +-+ +-+ +-+-+ +-+ + + +-+-+-+ +-+ +-+-+ +-+-+ +
|     | | |   |   | | |   | | | |   | | | |   |     | |     | |     |   | |   |       |     |       |
+-+ + +-+ + +-+ +-+ +-+-+ +-+-+-+ +-+ +-+ + +-+ +-+ +-+-+-+ +-+-+-+ +-+ + + + +-+ + +-+-+ +-+-+ +-+ +
|   | |     |       | |   |   |   |           | | | | | | | |   | | |   | | |   | |   |   | |     | |
+-+ +-+-+ + + + +-+-+ +-+-+ +-+ + +-+ + + + +-+ + + + + + +-+ +-+ +-+ + +-+-+ +-+ +-+-+-+ + +-+ +-+-+
| | |     | | |       |         |   | | | | |   |               | |   |   |     |   |       |   |   |
+ +-+ + +-+ +-+ +-+ +-+ +-+-+ +-+-+ +-+ + +-+-+ + + +-+-+-+-+ +-+ +-+ + +-+ +-+-+ +-+-+ +-+ +-+ + +-+
|     | |   |     | |   |     |       | |     | | |         | | | |   | | |   |     |   |   |       |
+-+ + + +-+-+ + +-+ + + + +-+ +-+-+-+ + + + + + + +-+-+-+ + +-+ + + +-+ + + +-+ + +-+ + +-+-+ +-+-+ +
|   | | |     | |   | | | |       |   | | | | | |       | |     |     | |   |   | |   | |   |     | |
+ +-+-+-+-+ + +-+-+ + + +-+-+-+-+-+-+-+ + + +-+ + + + +-+-+ + +-+-+ + +-+-+ +-+-+ +-+-+ + +-+ + + +-+
| |   |     | |     | |     |   | |   | | | |   | | |     | |   |   |   |   | |   | |     |   | |   |
+-+ + +-+-+ +-+-+-+ + +-+ +-+-+ + +-+ +-+ +-+-+-+-+ + +-+-+-+ + +-+ + +-+-+-+ + +-+ +-+ + +-+ +-+ + +
| | |       |     | | |   |       |       |   |     |       | |   | | | |         |   | | |   |   | |
+ +-+ + +-+ +-+ + + +-+-+-+-+-+ +-+-+ +-+ + +-+-+ + +-+ +-+-+-+ +-+ + + +-+-+ + +-+-+ + +-+ + +-+ + +
|     |   |   | |     |               |     |     |   |       |   | | |       |   |       | |   | | |
+-+-+-+-+-+-+-+-+-+-+-+-+-+-+-+-+-+-+-+-+-+-+-+-+-+-+-+-+-+-+-+-+-+-+-+-+-+-+-+-+-+-+-+-+-+-+-+-+-+-+